Humans: 0
GGGGGGGGGGGGGGGGGGGGGGGGGGGG
RL.....@....L........L...LRG
RL..........L........L...LRG
RLRRRRRRRRRRLRRRRRRRRLRRRLRG
RLM...L.....L.L......L...LRG
R.....L.....C.L..........LRG
RRRRRRLRRRRRRRLRRRRRRRRRRLRG
RL....L...L...L.....L...MLRG
RL........L.........L....LRG
RLRRRRRRRRLRRRRRRRRRLRRRRLRG
RL.M......L.........L....LRG
R.........L..............LRG
RRRRRRRRRRLRRRRRRRRRRRRRRLRG
R.........L..............LRG
R.........................RG
RRRRRRRRRRRRRRRRRRRRRRRRRRRG