Humans: 0
RRRRRRRRRRRRRRRRRRRRRRRRRRRR
RL.....@....L........L....RG
RL..........L........L....RG
RLRRRRRRRRRRLRRRRRRRRLRRRRRG
RLM...L.....L.L......L...LRG
R.....L.....C.L..........LRG
RRRRRRLRRRRRRRLRRRRRRRRRRLRG
RL....L...L...L.....L...MLRG
RL........L.........L.....RG
RLRRRRRRRRLRRRRRRRRRLRRRRRRG
RL.M......L.........L.....RG
R.........................RG
RRRRRRRRRRRRRRRRRRRRRRRRRRRG