Humans: 0
WGGGGGGGGGGGGGGGGGGGGGGGGGW
WL.....@....L........L...LW
WL..........L........L...LW
WLRRRRRRRRRRLRRRRRRRRLRRRLW
WLM...L.....L.L......L...LW
W.....L.....C.L..........LW
WRRRRRLRRRRRRRLRRRRRRRRRRLW
WL....L...L...L.....L...MLW
WL........L.........L....LW
WLRRRRRRRRLRRRRRRRRRLRRRRLW
WL.M......L.........L....LW
W.........L..............LW
WRRRRRRRRRLRRRRRRRRRRRRRRLW
W.........L..............LW
W.........................W
WRRRRRRRRRRRRRRRRRRRRRRRRRW