Humans: 0
RRRRRRRRRRRRRRRRRRRRRRRRRR
R.....@............L....RG
R..................L....RG
RRRRRRRRRRRRRRRRRRRLRRRRRG
R.....L............L....RG
R.....L.................RG
RRRRRRLRRRRRRRRRRRRRRRRRRG
R.....L............L....RG
R..................L....RG
RRRRRRRRRRRRRRRRRRRRRRRRRR